#########
#       #
#     ######
#          #
#####   P  #
#    ##    #
#    ##    #########
#                  #
#    O  XX         #
#       #    O     #
###########    #####
       #       #
       #       #
       #       #
       #########