#########
#      O#
#     ######
#          #
#####   P  #
#    ##    #
#    ##    #########
#         XXXX     #
#         OOOO     #
#       #          #
###########    #####
       #       #
       #     X #
       #       #
       #########