#########
#      O#
#     ######
#          #
#####   P  #
#    ##    #
# X  ##    #########
#         XX       #
#         OOOO     #
#       #          #
###########    #####
       #       #
       #     XX#
       #       #
       #########